{
    "dimension": [6, 8],
    "grids": [
              [4,4,2,0,-1,8,10,0],
              [4,0,0,0,1,6,10,11],
              [2,12,11,11,0,10,6,2],
              [10,7,7,2,-1,11,-1,10],
              [8,6,14,0,10,4,6,3],
              [10,2,2,11,6,4,2,0]
              ]
}
