{
    "dimension": [8, 10],
    "grids": [
              [0,0,0,0,0,0,0,0,10,8],
              [1,2,2,11,12,0,11,-1,10,8],
              [4,5,10,8,10,9,8,2,11,8],
              [-1,8,9,10,8,0,10,0,1,10],
              [0,-1,-1,8,8,10,-1,14,4,2],
              [1,4,3,0,6,-1,4,5,4,2],
              [6,-1,8,8,-1,2,4,-1,1,10],
              [8,10,-1,-1,8,10,2,8,9,8]
              ]
}
