{
    "dimension": [6, 8],
    "grids": [
              [0,2,-1,6,8,8,8,8],
              [4,-1,8,-1,6,6,8,9],
              [14,0,11,0,5,-1,8,8],
              [0,0,-1,-1,4,-1,-1,9],
              [-1,10,2,0,6,5,-1,8],
              [4,0,4,0,0,1,0,9]
              ]
}
