{
    "grids": [
              [9,6,7,8,5,7,7,2,10,7],
              [4,0,8,2,5,4,7,2,11,8],
              [2,2,7,4,5,9,2,2,5,2],
              [4,4,5,7,3,6,3,5,1,1],
              [1,9,6,9,6,4,5,3,3,3],
              [1,0,3,0,6,11,2,11,4,3],
              [11,0,8,11,9,10,10,5,7,5],
              [11,2,2,9,9,6,2,2,3,6]
              ]
}
