{
    "dimension": [6, 8],
    "grids": [
              [9,6,7,8,5,7,7,2],
              [4,0,8,2,5,4,7,2],
              [2,2,7,4,5,9,2,2],
              [4,4,5,7,3,6,3,5],
              [1,9,6,9,6,4,5,3],
              [1,0,3,0,6,11,2,11]
              ]
}
