{
    "dimension": [8, 10],
    "grids": [
              [0,12,10,8,-1,0,14,4,2,0],
              [4,0,8,10,-1,0,10,4,6,8],
              [6,11,8,11,8,11,2,6,6,9],
              [10,0,10,10,8,5,4,3,11,0],
              [9,9,12,0,5,4,-1,0,0,10],
              [8,8,10,11,6,2,10,11,4,8],
              [-1,9,-1,8,10,10,-1,0,-1,8],
              [0,0,10,8,9,8,8,2,10,8]
              ]
}


